101
XXXXXXXXXXXXXXXXXXXXXXXXXXXXXXXXXXXXXXXXXXXXXXXXXXXXXXXXXXXXXXXXXXXXXXXXXXXXXXXXXXXXXXXXXXXXXXXXXXXXX
XSX     X#####X###X   X   X#############X     X   X         X         X   X X   X X         X   X   X
X#X XXXXX#XXX#X#X#XXX X XXX#XXXXXXXXXXX#XXXXX X X XXX XXX X X XXX XXX XXX X X X X X XXXXXXX X X X X X
X#X   X###X X###X#X     X###X       X###X   X X X   X   X X X X   X   X   X   X   X X     X X X X X X
X#X X X#XXX XXXXX#X XXX X#XXXXX XXXXX#X X X X X XXX XXX X X XXX XXX XXX XXXXXXX XXX X XXX XXX X X X X
X#  X X#X       X#####X X#X###    X###X X X X X   X   X X X X   X X           X   X   X   X   X X X X
X#XXX X#X XXXXX XXXXX#X X#X#X#XXXXX#XXX X X X XXX XXX X X X X XXX X XXXXXXXXX XXX XXXXX X X XXX X X X
X#X X X#X     X   X###X X###X#####X#X     X X   X X     X X   X   X X       X   X     X X X X X X X X
X#X X X#XXXXX X XXX#XXX XXXXXXXXX#X#XXXXXXX X X X XXXXXXXXXXXXXXX XXX XXX XXXXX X X XXX X X X X X XXX
X#X   X#X     X   X#X   X       X#X#X#####X X X X         X     X     X   X   X X X   X X X X X     X
X#XXXXX#XXXXXXX X X#XXXXX X XXXXX#X#X#XXX#X XXX XXXXXXXXX X XXX XXXXX XXXXX X X X XXX X XXX X XXXXX X
X#####X#X#####X X X#######X X#####X###X###X X   X       X   X X   X   X     X X   X   X         X   X
XXXXX#X#X#XXX#X X XXXXXXX#XXX#XXXXXXXXX#XXX X X XXXXXXX XXXXX XXX X X X XXXXX XXXXX XXX XXXXXXXXX X X
X    #X###X###X X     X X###X#X       X#X X X X       X     X   X X X X     X       X X X X   X   X X
X XXX#XXXXX#XXX X XXX X XXX#X#X XXX X X#X X X X XXXXX XXXXX XXX X X XXXXX XXXXXXXXXXX X X X X X XXX X
X X X#    X###X X X     X X#X#X   X X X#X   X X     X X         X X         X       X     X X X   X X
X X X#XXXXXXX#X X XXXXXXX X#X#XXXXX X X#XXX XXXXXXX X X XXXXXXX X XXXXXXXXX X XXXXX X XXXXX X XXX X X
X   X#####  X#X X     X   X#X#####  X X#X           X   X   X   X         X X     X X   X   X     X X
XXX XXXXX#X X#XXXXX X X X X#XXXXX#XXXXX#XXXXX XXXXXXXXXXX X X XXXXXXXXXXX X XXXXX X XXX X XXXXXXXXX X
X   X#####X X#####X X   X X#####X#X#####X   X X     X   X X             X X   X X X X   X X         X
X XXX#X XXXXXXXXX#XXXXXXX XXXXX#X#X#XXX X X XXX X X X XXX XXXXXXXXXXX XXX XXX X X X XXXXX X XXXXXXXXX
X X###X         X###########X X###X#X   X X     X X X     X   X     X X   X   X   X X   X X         X
XXX#XXXXXXXXXXX XXXXXXXXXXX#X XXXXX#X XXX XXXXXXX X XXXXXXX X X XXX XXX XXX XXX XXX X X X XXXXXXXXX X
X###X###X   X       X#######X X#####X   X X       X         X X X     X X X X X X   X X   X     X   X
X#XXX#X#X XXX X XXX X#XXXXXXX X#X XXXXXXX XXXXXXXXXXXXXXXXXXX X XXXXX X X X X X X X X XXXXX XXX X XXX
X#####X#X     X   X X#X     X X#X X     X       X           X   X     X X X X X X X   X     X X   X X
XXXXXXX#XXXXXXXXXXX X#X XXX X X#XXX XXX XXXXX X X XXXXXXX X XXXXX XXXXX X X X X X XXXXX XXXXX XXXXX X
X   X  #####X       X#X X   X X###X   X X   X X X X   X   X X   X X     X   X   X X X     X     X   X
X X X XXXXX#X XXXXX X#X X XXX XXX#XXX X X X X X XXX X X XXX X X X X XXXXX XXXXX X X X XXX XXX X X X X
X X X   X X#X X###X X###X X X   X###X X   X X X X   X   X   X X X X     X     X X X     X     X   X X
XXX XXX X X#XXX#X#XXXXX#X X X X XXX#X XXXXX XXX X XXX X X XXX X X XXXXX XXXXX XXX XXXXX XXXXXXXXXXXXX
X     X   X#X###X#X#####X     X   X#X   X     X X X   X X   X X X     X   X X   X     X X       X   X
X XXX XXX X#X#XXX#X#XXXXXXXXXXXXXXX#XXX XXXXX X X XXXXXXXXX X X XXXXX XXX X X X XXXXX XXX XXX X X X X
X   X   X X#X###X###X###############X X     X   X X     X   X X     X X   X   X   X       X   X X X X
XXX XXX X X#XXX#XXX X#XXXXXXXXXXX X X XXXXX XXXXX X XXX XXX X X X XXX X X XXXXX X XXXXXXXXX XXX X X X
X     X   X#  X###X X###X     X   X     X X     X X   X   X X X X X   X X     X X X       X X X   X X
XXXXX XXXXX#XXXXX#X XXX#X XXXXX XXXXXXX X XXXXX X XXX X X XXX X X X XXXXX XXX XXX X XXXXX X X XXXXX X
X   X X   X###X X#X   X#X         X   X   X     X     X X     X X X     X   X   X       X   X X   X X
X X X X X XXX#X X#XXX X#XXXXXXXXX X X XXXXX XXXXXXXXXXX XXXXXXX XXXXXXX XXXXX X XXXXX XXXXXXX X X X X
X X X X X   X#X X#X X X#X X     X X X   X   X   X     X       X     X X     X X X     X   X     X X X
X X X XXXXX X#X X#X X X#X X X XXX X XXX X XXX X X X X XXXXXXXXXXX X X XXXXX X X XXXXXXX X XXXXX X X X
X X X X     X#####X   X#X   X     X X   X X   X X X X   X         X X X     X X       X X   X   X   X
X XXX X XXXXXXXXXXXXXXX#XXX X XXXXX X XXX XXXXX X X XXX X XXXXXXXXX X X XXXXXXX XXXXX X XXX XXX XXXXX
X X   X       X#####X X###X X     X X     X   X   X   X X X X     X   X       X   X   X X X   X     X
X X XXX X XXX X#XXX#X XXX#XXXXXXX X XXXXXXX X XXXXXXX X X X X X X XXX XXXXXXX XXX X XXX X XXX XXXXX X
X X X   X X   X#X X#X X  #######X X   X     X   X X   X   X   X X X   X     X X   X         X     X X
X X XXXXX X XXX#X X#X X XXXXXXX#XXX X X XXXXXXX X X XXXXXXX XXX XXX XXXXX X X X XXXXXXXXX XXXXXXX X X
X         X X###X X#  X X     X#X   X X   X X   X X     X     X   X X     X X X       X X X       X X
XXXXXXXXXXXXX#XXX X#XXX X X XXX#X XXXXXXX X X XXX XXXXX XXXXXXX X X XXX XXX X XXXXXXX X X X XXXXXXX X
X X#####X#####X   X#X   X X   X#X         X X     X     X     X X     X X   X       X   X X   X     X
X X#XXX#X#XXXXXXX X#X XXXXX X X#XXXXXXXXXXX XXXXX XXX XXX XXX XXXXXXX XXX XXXXXXXXX XXX X XXX X XXXXX
X X#X###X#X       X#X     X X X#####X#######X   X   X X   X X     X X   X     X   X X   X   X X     X
X X#X#XXX#X X X XXX#XXXXX X X XXXXX#X#XXXXX#X X XXXXX X XXX XXXXX X XXX XXX X XXX X XXXXXXX X XXXXX X
X###X#X  #X X X   X#X     X X     X###X   X###X X   X   X   X   X X X   X   X     X     X X X     X X
X#XXX#XXX#X X XXXXX#XXXXX XXXXXXX XXXXXXX XXX#X XXX XXX X X XXX X X X XXX XXXXXXXXXXXXX X X XXXXX X X
X#X  #####X X     X#####X   X X   X         X#X       X   X     X X X     X       X   X X   X     X X
X#XXXXXXXXX XXXXX XXXXX#XXX X X X X XXXXXXXXX#XXXXXXX X XXXXXXXXX X XXX XXX X XXX X X X XXXXX XXX X X
X#########X X X       X#X   X X X   X   X   X#X#####X X X     X   X     X   X X X   X X X     X   X X
XXXXXXXXX#X X X XXXXXXX#X XXX X X XXX X X X X#X#XXX#X XXX XXX X XXX XXXXX XXX X XXX XXX X XXXXXXXXX X
X   X    #X   X   X#####X   X   X     X   X X###X###X     X     X     X     X X X   X   X X       X X
X X X XXX#XXXXXXX X#XXXXXXX XXXXXXXXXXXXXXX XXXXX#XXXXXXXXXXXXXXXXXXXXX XXXXX X X XXX XXX X XXXXX X X
X X X   X#X###X   X#X   X     X     X           X#####  X#######X       X     X     X X   X     X X X
X XXXXX X#X#X#X XXX#XXX X XXX X XXX X X XXXXXXX XXXXX#XXX#X XXX#X XXXXXXX XXXXXXXXX X X XXXXX X XXX X
X       X###X#X X###X###X   X   X   X X X###X       X#####X X###X       X   X     X X   X     X   X X
X X XXXXXXXXX#X X#XXX#X#XXX XXXXX XXXXX X#X#XXXXXXX XXXXXXX X#XXXXXXXXX XXX X X X X XXXXX XXXXXXX X X
X X   X###X###X X#X  #X###X X###X       X#X#######X X#####X X###X###X   X X   X X X   X X     X   X X
X XXX X#X#X#XXX X#XXX#XXX#XXX#X#XXXXXXXXX#XXXXXXX#XXX#XXX#X XXX#X#X#X XXX XXXXXXX XXX X X XXXXX XXX X
X X   X#X###X   X###X###X#X###X###X#####X#X X   X#X###X###X   X###X#X       X   X   X X   X     X   X
X XXXXX#XXXXXXX XXX#XXX#X#X#XXXXX#X#XXX#X#X X X X#X#XXX#XXXXX XXXXX#XXXXXXX X X XXX X XXXXX XXX X XXX
X X###X#X       X X###X#X###X   X###X###X#X X X X#X###X#X     X   X#      X   X   X X X   X   X X X X
X X#X#X#X X X X X XXX#X#XXXXX X XXXXX#XXX#X X X X#XXX#X#X XXXXX XXX#X XXXXXXXXXXX X X X X XXX X X X X
X X#X###X X X X     X###X   X X   X###X###X   X  #X###X#X     X X###X   X   X X   X X X X     X X X X
XXX#XXXXX X XXXXXXXXXXXXXXX X XXX X#XXX#XXXXXXXXX#X#XXX#XXXXX X X#XXXXX X X X X XXX X X X XXXXXXX X X
X  #X     X                 X X   X#X###X X#######X###X#X       X#X X   X X X X X X X   X X       X X
X X#X XXXXXXXXXXXXXXXXX XXXXX XXXXX#X#XXX X#XXXXXXXXX#X#X XXXXXXX#X X X X X X X X X XXXXX X XXXXXXX X
X X#X X               X            ###X X X#####X  ###X#X X#######X   X   X   X X X     X X   X X   X
XXX#X XXXXX X XXXXXXXXXXXXXXX XXXXXXXXX X XXXXX#XXX#XXX#X X#XXXXXXXXXXXXXXXXXXX X XXXXX XXXXX X X X X
X###X X   X X   X###########X     X       X   X#####X X#X X#X#########X#######X X     X     X   X X X
X#XXX X X X X X X#XXXXXXXXX#XXXXX X XXXXXXX XXXXXXXXX X#XXX#X#XXXXXXX#X#XXXXX#X X X XXXXXXX XXX X X X
X#X   X X X X X X#####X   X#X     X X                  #####X#####X X###X   X#X   X   X   X   X X X X
X#XXX X X XXX X XXXXX#X XXX#X XXXXX X XXXXXXXXXXXXX XXXXXXXXXXXXX#X XXXXX X X#XXXXXXX XXX XXX X XXX X
X#X   X X     X X#####X   X#X X###X   X#########X     X###X###X###X     X X X#X   X   X     X X   X X
X#X XXX XXXXXXX X#XXXXXXX X#XXX#X#XXXXX#XXXXXXX#XXXXX X#X#X#X#X#XXX X X X XXX#XXX XXX X XXX X XXX X X
X#X     X     X X#X  #####X###X#X#######  X#####X   X X#X###X###X   X X   X###X   X   X   X X   X X X
X#XXXXXXXXX XXX X#XXX#XXX#XXX#X#X XXXXXXXXX#XXXXX X X X#XXXXXXXXXXXXX XXXXX#X X XXX XXXXXXX XXX X X X
X#X#######X     X#X###X X#X X###X       X###X     X X X#########X     X#####X X   X X       X X X   X
X#X#XXX X#XXXXXXX#X#XXX X#X XXXXXXXXXXX X#XXX XXX XXX XXXXXXXXX#X XXX X#XXXXXXX X X X XXXXX X X XXX X
X#X###X X#X#####X###X   X#X X     X###X X###X   X     X       X#X   X X#  X     X X   X     X X     X
X#XXX#X X#X#XXX#XXXXX XXX#X X XXX X#X#XXXXX#XXX X XXXXXXXXXXX X#X X X X#XXX XXXXX XXXXX XXXXX XXXXXXX
X#X###X X#X###X#    X X###X X X   X#X#######X   X X   X       X#X X X X###X X   X       X X       X X
X#X#XXXXX#XXX#X#X XXX X#XXX X XXX X#XXXXXXXXXXXXX X X X XXXXXXX#X X XXXXX#X X X XXXXXXXXX X XXXXX X X
X###X###X#####X#X   X X#X   X X   X#####X#######X   X X#####X###X X   X###X   X X       X X X   X   X
X XXX#X#XXXXXXX#XXX X X#X X X X XXXXXXX#X#XXXXX#XXXXX X#XXX#X#XXXXXXX X#XXXXXXX XXXXX X X X X X XXX X
X X###X#########X   X###X X X X   X   X###X   X#####X X#  X###X     X X#    X X     X X X X   X   X X
X X#XXXXXXXXXXXXXXXXX#XXX X X X X XXX XXXXXXX XXXXX#X X#XXXXXXX XXX X X#XXX X XXXXX X X X X XXXXX XXX
X X#######X###########X   X X X X     X       X#####X X#X     X X     X###X   X###X X X X X X   X###X
X XXXXXXX#X#X XXXXXXXXX XXX X X XXXXX XXX XXXXX#XXXXX X#X XXX X X XXXXXXX#XXXXX#X#X X X X X X X X#X#X
X   X    ###X X   X   X   X   X   X X   X X   X###X   X###X X   X   X   X#X#####X#X X X       X X#X#X
XXX XXXXXXXXXXX X X X XXXXXXX XXX X X X X X X X X#XXXXXXX#X XXXXXXX X X X#X#XXXXX#X XXXXXXXXXXXXX#X#X
X               X   X         X   X   X   X X   X#########X           X X###    X#################XEX
XXXXXXXXXXXXXXXXXXXXXXXXXXXXXXXXXXXXXXXXXXXXXXXXXXXXXXXXXXXXXXXXXXXXXXXXXXXXXXXXXXXXXXXXXXXXXXXXXXXXX

